*****************************************
*           *       *     *   *   *     *
* *** ***** * ***** * * * * * * * * *** *
* *   *   * * *   * * * *   *   * * *   *
* * *** * * * * *** * * * ******* * * ***
* *   * * * * * *   * * * *   *     *   *
* *** * *** * * * *** * *** * * ******* *
*   * *     *   *   * *     * * *   * * *
***** ********* *** * ******* *** * * * *
*     *         * * * *     *     * *   *
* ***** ********* * * * *** ******* * ***
*       *         * * *   *     *   *   *
* ********* ***** * * * *** ***** * *****
* *       * *     *   * *   *   * * *   *
* * ***** *** *** ***** * *** * * *** * *
*   *   *     * * *   * *   * *   *   * *
***** * ******* * * * ***** * *** * *****
*   * *     *       *     * * *   *     *
* * * * ***** *********** * * * ******* *
* * * *       *     *     * * *     *   *
* *** ********* *** ***** * * ***** *   *
*   * *   *     *   *   *   * *     *   *
* * * *** * ***** *** * ***** ********* *
* * *     *   * *     * *   *       *   *
* * ***** *** * ******* * * ******* * ***
* *     * *   *           *         *   *
* *** *** * ************* ******* ***** *
* * *     *         *   * *   *   *   * *
* * *************** * * *** * ***** * * *
*                 *   *     *       *   *
*****************************************